####################
#........B....~~...#
#..B...####...B....#
#......#..#........#
#..P...#..#....B...#
#......#..#........#
#..B...####...B....#
#........B....~~...#
####################
